-0 -0 -0 -0 -0 -0 -0 -0 0 0 0 0 0 0 0 0 0 
-247 -216 -185 -155 -124 -93 -62 -31 0 31 62 93 124 155 185 216 247 
-470 -411 -353 -294 -235 -176 -118 -59 0 59 118 176 235 294 353 411 470 
-647 -566 -485 -405 -324 -243 -162 -81 0 81 162 243 324 405 485 566 647 
-761 -666 -571 -476 -380 -285 -190 -95 0 95 190 285 380 476 571 666 761 
-800 -700 -600 -500 -400 -300 -200 -100 0 100 200 300 400 500 600 700 800 
-761 -666 -571 -476 -380 -285 -190 -95 0 95 190 285 380 476 571 666 761 
-647 -566 -485 -405 -324 -243 -162 -81 0 81 162 243 324 405 485 566 647 
-470 -411 -353 -294 -235 -176 -118 -59 0 59 118 176 235 294 353 411 470 
-247 -216 -185 -155 -124 -93 -62 -31 0 31 62 93 124 155 185 216 247 
-0 -0 -0 -0 -0 -0 -0 -0 0 0 0 0 0 0 0 0 0 
247 216 185 155 124 93 62 31 -0 -31 -62 -93 -124 -155 -185 -216 -247 
470 411 353 294 235 176 118 59 -0 -59 -118 -176 -235 -294 -353 -411 -470 
647 566 485 405 324 243 162 81 -0 -81 -162 -243 -324 -405 -485 -566 -647 
761 666 571 476 380 285 190 95 -0 -95 -190 -285 -380 -476 -571 -666 -761 
800 700 600 500 400 300 200 100 -0 -100 -200 -300 -400 -500 -600 -700 -800 
761 666 571 476 380 285 190 95 -0 -95 -190 -285 -380 -476 -571 -666 -761 
647 566 485 405 324 243 162 81 -0 -81 -162 -243 -324 -405 -485 -566 -647 
470 411 353 294 235 176 118 59 -0 -59 -118 -176 -235 -294 -353 -411 -470 
247 216 185 155 124 93 62 31 -0 -31 -62 -93 -124 -155 -185 -216 -247 
0 0 0 0 0 0 0 0 -0 -0 -0 -0 -0 -0 -0 -0 -0 

