0  -313  -610  -856  -1024  -1091  -1048  -899  -656  -346  0  346  656  899  1048  1091  1024  856  610  313  0  
313  0  -299  -552  -734  -825  -818  -715  -528  -280  0  280  528  715  818  825  734  552  299  0  -313  
610  299  0  -258  -453  -568  -595  -536  -403  -216  0  216  403  536  595  568  453  258  0  -299  -610  
856  552  258  0  -203  -335  -391  -372  -288  -157  0  157  288  372  391  335  203  0  -258  -552  -856  
1024  734  453  203  0  -143  -219  -232  -189  -105  0  105  189  232  219  143  0  -203  -453  -734  -1024  
1091  825  568  335  143  0  -88  -122  -110  -64  0  64  110  122  88  0  -143  -335  -568  -825  -1091  
1048  818  595  391  219  88  0  -45  -53  -34  0  34  53  45  0  -88  -219  -391  -595  -818  -1048  
899  715  536  372  232  122  45  0  -17  -14  0  14  17  0  -45  -122  -232  -372  -536  -715  -899  
656  528  403  288  189  110  53  17  0  -4  0  4  0  -17  -53  -110  -189  -288  -403  -528  -656  
346  280  216  157  105  64  34  14  4  0  0  0  -4  -14  -34  -64  -105  -157  -216  -280  -346  
-0  0  0  0  0  0  0  0  0  0  0  0  0  0  0  0  0  0  0  0  0  
-346  -280  -216  -157  -105  -64  -34  -14  -4  0  0  0  4  14  34  64  105  157  216  280  346  
-656  -528  -403  -288  -189  -110  -53  -17  0  4  0  -4  0  17  53  110  189  288  403  528  656  
-899  -715  -536  -372  -232  -122  -45  0  17  14  0  -14  -17  0  45  122  232  372  536  715  899  
-1048  -818  -595  -391  -219  -88  0  45  53  34  0  -34  -53  -45  0  88  219  391  595  818  1048  
-1091  -825  -568  -335  -143  0  88  122  110  64  0  -64  -110  -122  -88  0  143  335  568  825  1091  
-1024  -734  -453  -203  0  143  219  232  189  105  0  -105  -189  -232  -219  -143  0  203  453  734  1024  
-856  -552  -258  0  203  335  391  372  288  157  0  -157  -288  -372  -391  -335  -203  0  258  552  856  
-610  -299  0  258  453  568  595  536  403  216  0  -216  -403  -536  -595  -568  -453  -258  0  299  610  
-313  0  299  552  734  825  818  715  528  280  0  -280  -528  -715  -818  -825  -734  -552  -299  0  313  
0  313  610  856  1024  1091  1048  899  656  346  -0  -346  -656  -899  -1048  -1091  -1024  -856  -610  -313  0 
