71  58  19  -29  -67  -88  -91  -81  -68  -58  -54  -58  -68  -81  -91  -88  -67  -29  19  58  71  
58  13  -42  -81  -91  -74  -42  -7  22  40  46  40  22  -7  -42  -74  -91  -81  -42  13  58  
19  -42  -84  -88  -54  -1  52  90  112  121  124  121  112  90  52  -1  -54  -88  -84  -42  19  
-29  -81  -88  -46  22  85  121  128  115  100  94  100  115  128  121  85  22  -46  -88  -81  -29  
-67  -91  -54  22  95  128  111  61  7  -33  -47  -33  7  61  111  128  95  22  -54  -91  -67  
-88  -74  -1  85  128  100  19  -75  -145  -182  -192  -182  -145  -75  19  100  128  85  -1  -74  -88  
-91  -42  52  121  111  19  -104  -192  -217  -202  -189  -202  -217  -192  -104  19  111  121  52  -42  -91  
-81  -7  90  128  61  -75  -192  -210  -124  -7  47  -7  -124  -210  -192  -75  61  128  90  -7  -81  
-68  22  112  115  7  -145  -217  -124  109  352  455  352  109  -124  -217  -145  7  115  112  22  -68  
-58  40  121  100  -33  -182  -202  -7  352  698  841  698  352  -7  -202  -182  -33  100  121  40  -58  
-54  46  124  94  -47  -192  -189  47  455  841  880  841  455  47  -189  -192  -47  94  124  46  -54  
-58  40  121  100  -33  -182  -202  -7  352  698  841  698  352  -7  -202  -182  -33  100  121  40  -58  
-68  22  112  115  7  -145  -217  -124  109  352  455  352  109  -124  -217  -145  7  115  112  22  -68  
-81  -7  90  128  61  -75  -192  -210  -124  -7  47  -7  -124  -210  -192  -75  61  128  90  -7  -81  
-91  -42  52  121  111  19  -104  -192  -217  -202  -189  -202  -217  -192  -104  19  111  121  52  -42  -91  
-88  -74  -1  85  128  100  19  -75  -145  -182  -192  -182  -145  -75  19  100  128  85  -1  -74  -88  
-67  -91  -54  22  95  128  111  61  7  -33  -47  -33  7  61  111  128  95  22  -54  -91  -67  
-29  -81  -88  -46  22  85  121  128  115  100  94  100  115  128  121  85  22  -46  -88  -81  -29  
19  -42  -84  -88  -54  -1  52  90  112  121  124  121  112  90  52  -1  -54  -88  -84  -42  19  
58  13  -42  -81  -91  -74  -42  -7  22  40  46  40  22  -7  -42  -74  -91  -81  -42  13  58  
71  58  19  -29  -67  -88  -91  -81  -68  -58  -54  -58  -68  -81  -91  -88  -67  -29  19  58  71  

