 0 0 0 0 29 27 28 29 31 29 29 29 31 29 29 28 29 27 0 0
 0 0 0 27 29 31 31 32 31 31 31 31 32 30 31 29 28 28 27 0
 27 27 27 28 30 31 34 32 34 34 34 34 35 33 33 31 30 29 29 27
 27 28 28 28 31 32 32 31 36 34 35 35 32 33 31 33 31 30 29 28
 29 28 29 29 34 33 36 33 38 35 35 36 38 32 34 33 34 32 31 29
 28 29 31 32 33 34 36 37 36 34 35 35 33 32 30 33 35 32 30 30
 29 31 33 33 34 31 35 36 39 36 38 33 35 32 32 31 36 31 33 30
 29 32 31 31 33 32 33 35 35 41 43 36 34 32 32 32 36 32 31 31
 31 30 32 31 38 34 36 37 44 41 40 40 44 34 35 35 38 34 34 31
 30 30 31 32 35 38 35 40 39 39 40 37 40 41 38 39 33 30 30 31
 30 30 32 34 39 40 41 36 43 46 48 38 44 43 41 33 34 30 31 30
 29 30 31 33 37 40 39 38 42 39 38 42 42 41 35 33 33 32 31 30
 31 30 33 32 38 37 36 35 44 39 38 39 44 38 39 36 38 33 33 31
 30 31 31 33 32 32 30 35 38 41 37 39 42 37 35 33 33 33 34 30
 29 31 33 33 33 30 31 33 37 40 37 36 39 38 37 34 31 31 33 30
 28 29 30 32 31 31 31 32 36 37 35 34 34 35 38 35 32 29 30 30
 29 28 29 29 34 30 32 31 38 35 35 36 38 33 34 33 34 30 31 29
 27 28 28 30 32 30 31 32 32 31 33 35 32 30 31 31 29 31 29 28
 27 28 29 30 31 31 31 31 32 32 35 31 31 30 32 30 30 29 29 27
 0 27 27 28 29 29 29 30 31 30 33 31 29 32 29 30 28 27 27 0
