30 30 30 30 30 30 30 30 20 10 0 -10 -20 -30 -30 -30 -30 -30 -30 -30 -30 
30 30 30 30 30 30 30 27 18 9 0 -9 -18 -27 -30 -30 -30 -30 -30 -30 -30 
30 30 30 30 30 30 30 24 16 8 0 -8 -16 -24 -30 -30 -30 -30 -30 -30 -30 
30 30 30 30 30 30 28 21 14 7 0 -7 -14 -21 -28 -30 -30 -30 -30 -30 -30 
30 30 30 30 30 30 24 18 12 6 0 -6 -12 -18 -24 -30 -30 -30 -30 -30 -30 
30 30 30 30 30 25 20 15 10 5 0 -5 -10 -15 -20 -25 -30 -30 -30 -30 -30 
30 30 30 28 24 20 16 12 8 4 0 -4 -8 -12 -16 -20 -24 -28 -30 -30 -30 
30 27 24 21 18 15 12 9 6 3 0 -3 -6 -9 -12 -15 -18 -21 -24 -27 -30 
20 18 16 14 12 10 8 6 4 2 0 -2 -4 -6 -8 -10 -12 -14 -16 -18 -20 
10 9 8 7 6 5 4 3 2 1 0 -1 -2 -3 -4 -5 -6 -7 -8 -9 -10 
0 0 0 0 0 0 0 0 0 0 0 0 0 0 0 0 0 0 0 0 0 
-10 -9 -8 -7 -6 -5 -4 -3 -2 -1 0 1 2 3 4 5 6 7 8 9 10 
-20 -18 -16 -14 -12 -10 -8 -6 -4 -2 0 2 4 6 8 10 12 14 16 18 20 
-30 -27 -24 -21 -18 -15 -12 -9 -6 -3 0 3 6 9 12 15 18 21 24 27 30 
-30 -30 -30 -28 -24 -20 -16 -12 -8 -4 0 4 8 12 16 20 24 28 30 30 30 
-30 -30 -30 -30 -30 -25 -20 -15 -10 -5 0 5 10 15 20 25 30 30 30 30 30 
-30 -30 -30 -30 -30 -30 -24 -18 -12 -6 0 6 12 18 24 30 30 30 30 30 30 
-30 -30 -30 -30 -30 -30 -28 -21 -14 -7 0 7 14 21 28 30 30 30 30 30 30 
-30 -30 -30 -30 -30 -30 -30 -24 -16 -8 0 8 16 24 30 30 30 30 30 30 30 
-30 -30 -30 -30 -30 -30 -30 -27 -18 -9 0 9 18 27 30 30 30 30 30 30 30 
-30 -30 -30 -30 -30 -30 -30 -30 -20 -10 0 10 20 30 30 30 30 30 30 30 30 
